TTTTTTTTTTT
TTTTTTTTTTT
TTXXXXXXXTT
TTXTTXTTXTT
TTXTTXTTXTT
TTXTTXTTXTT
SXXTTBTTXXS
TTXTTXTTXTT
TTXTTXTTXTT
TTXTTXTTXTT
TTXXXXXXXTT
TTTTTTTTTTT
TTTTTTTTTTT