TTXXXXXXXXS
TTXTTTTTTTT
TTXTTTTTTTT
TTXTTXXXXTT
TTXTTXTTXTT
TTXTTXTTXTT
TTXTTXTTXTT
TTXTTXTTXTT
TTXTTBTTXTT
TTXTTTTTXTT
TTXTTTTTXTT
TTXTTTTTXTT
TTXXXXXXXXS