SXXXXXXXXTS
TTTTTTTTXTX
TTTTTTTTXTX
XXXXXXXTXTX
XTTTTTXTXTX
XTXXXTXTXTX
XTXTXBXXXTX
XTXTXTTTTTX
XTXTXTTTTTX
XTXTXXXXXXX
XTXTTTTTTTT
XTXTTTTTTTT
STXXXXXXXXS