TTTTTBTTTTT
TXXXTXTXXXT
TXTXTXTXTXT
TXTXTXTXTXT
TXTXTXTXTXT
TXTXTXTXTXT
TXTXTXTXTXT
TXTXTXTXTXT
TXTXTXTXTXT
TXTXTXTXTXT
TXTXTXTXTXT
TXTXXXXXTXT
TSTTTTTTTST