TXXXXSXXXXT
TXTTTXTTTXT
TXTTTXTTTXT
TXTTTXTTTXT
TXTTTXTTTXT
TXTTTXTTTXT
TXTTTXTTTXT
TXTTTXTTTXT
TXTTTXTTTXT
TXTTTXTTTXT
TXTTTXTTTXT
TXXXXXXXXXT
TTTTTBTTTTT