TTTTTTTTTTS
TXXXXXXXTTX
TXTTTTTXTTX
TXTXXXXXTTX
TXTXTTTTTTX
TXTXTTTTTTX
TXTXTBXXXTX
TXTXTTTTXTX
TXTXTTTTXTX
TXTXXXXXXTX
TXTTTTTTTTX
TXTTTTTTTTX
TXXXXXXXXXX