STTTTBTTTTS
XTTTTXTTTTX
XTTTTXTTTTX
XXXXTXTXXXX
TTTXTXTXTTT
TTTXTXTXTTT
XXXXTXTXXXX
XTTTTXTTTTX
XTTTTXTTTTX
XXXTTXTTXXX
TTXTTXTTXTT
TTXTTXTTXTT
TTXXXXXXXTT