TTXXXXXXXXS
TTXTTTTTTTT
TTXXXXXXXTS
TTXTTXTTXTX
TTXTTXTTXTX
TTXTTXTTXTX
XXXTTXTTXXX
XTXTTXTTXTT
XTXTTBTTXTT
XTXTTTTTXTT
STXXXXXXXTT
TTTTTTTTXTT
SXXXXXXXXTT