TTTTTSTTTTT
TXXXXXXXXXT
TXTTTXTTTXT
TXTTTXTTTXT
TXTTTXTTTXT
TXTTTXTTTXT
TXXXXXXXXXT
TXTTTXTTTXT
TXTTTXTTTXT
TXTTTXTTTXT
TXTTTXTTTXT
TXXXXXXXXXT
TTTTTBTTTTT