SXXXXSXXXXS
XXTTXXXTTXX
XTTTTXTTTTX
XXTTXXXTTXX
XXXXXXXXXXX
XXTTXXXTTXX
XTTTTXTTTTX
XXTTXXXTTXX
XXXXXXXXXXX
XXTTXXXTTXX
XTTTTXTTTTX
XXTTXXXTTXX
XXXTXBXTXXX