FFFFFSFFFFF
FFFFFXFFFFF
TTTTTXTTTTT
TTTTTXTTTTT
TXXXTXTTTTT
TXTXTXTTTTT
SXXXXBXXXXS
TTTTTXTXTXT
TTTTTXTXXXT
TTTTTXTTTTT
TTTTTXTTTTT
FFFFFXFFFFF
FFFFFSFFFFF