STTTTXXXXXX
XTTTTXTTTTX
XTTTTXTTTTX
XTTTTXTTTTX
XTTTTXTTTTX
XTTTTXTTTTX
XXXXXBXXXXX
XTTTTXTTTTX
XTTTTXTTTTX
XTTTTXTTTTX
XTTTTXTTTTX
XTTTTXTTTTX
XXXXXXTTTTS