SXXXXXXXXXS
TTTTTXTTXTT
TTTXXXTTXXT
TTTXTTTTXTT
TTTXXXTTXXS
TTTTTXTTXTT
XXXXXXTTXXT
XTTTTTTTTXX
XXXBXXTTTTX
TTTTTXTTTTX
TTTXXXTTTXX
TTTXTTTXXXT
TTTXXXXXTTT