SXXXXXXXXTS
TTTTTTTTXTX
TTTTTTTTXTX
TTXXXXTTXTX
TTXTTXTTXTX
TTXTTXTTXTX
TTXTTBTTXTX
TTXTTXXXXTX
TTXTTTTTTTX
TTXTTTTTTTX
TTXXXXXXXXX
TTTTTTTTTTT
TTTTTTTTTTT