XXXXXXXXXXS
XTTTTXTTTXX
XTTTTXTTTTX
XXXXXXXXXXX
TTXTTXTTTTX
TTXTTXTTTTX
TTXTTXXXXXX
TTXTTXTTXTT
TTXTTXTTXTT
TTXTTXTTXTT
TTXTTXTTXTT
TTSTTXTTSTT
TTTTTBTTTTT