TTTXXXXXXTT
TTTXTTTTXTT
TTXXSTTTSXX
TTXTTTTTTTX
TTXTTTTTTTX
TTXXXXXXXXX
TTTTXTTTTTX
TTTTXTTTTTX
TTTTXTTTTTX
TTXXXXXBXXX
TTXTTTTXTTX
TTXTTTTXTTX
TTXXXXXXXXX