TSTFTSTFTST
TXTFTXTFTXT
TXTXXXXXTXT
XXXXTTTXXXX
TTXXTTTXXTT
TTXXTTTXXTT
TTXXTTTXXTT
TXXXXXXXXXT
XXXXXXXXXXX
TTXTTTTTXTT
TTXXTTTXXTT
TTTXXXXXTTT
TTTXXBXXTTT