XXXXXXXXXXX
TTXTTXTTXTT
TTXTTXTTXTT
XXXXXXXXXXX
TTXTTXTTXTT
TTXTTXTTXTT
XXXXXXXXXXX
TTTTTXTTTTX
TTTTTXTTTTX
TTTTTXTTTTX
TTTTTXTTTTX
TTTTTXTTTTX
TTTTTBTTTTS