TTXXXXTTTTT
TTXTTXTTTTT
TTXTTXTXXXT
XXXTTXXXXXX
XTTTTXTTXTT
BTTTTXTTXTT
TTTTTXTTXTT
TTTTTXTTXTT
TTTTTSTTXTT
TTTTTTTTXTT
TTTTTTTTXTT
TTSXXXXXXTT
TTTTTTTTTTT