XXXXXSXXXXX
TTXXTTTXXTT
TXXTTTTTXXT
TXXXXXXXXXT
TTTTTXTTTTT
XXXXXXXXXXX
TTTXTTTXTTT
TTTXTTTXTTT
TXXXXXXXXXX
TXTTTTTTTXT
TXXXXXXXXXT
TTTTTXTTTTT
TTTTTBTTTTT