TTTTTTTTTST
TTTTTTTTTXT
TXXXXXTTXXT
TXTTXXXXXTT
TXTTTTTTTTT
TXXXXXXTTTT
TTTTTTXTXXB
TTTTTXXTXTT
TTTTTXTTXTT
TXXXXXTTXXT
TXTTTTTTTXT
TXXXXXXXXXT
TTTTTTTTTTT