XXXXXXTSXXX
XTTTTXTTTTX
XTTTTXTTTTX
XTTTTXTTTTX
STTTTXTTTTX
TTTTTXTTTTX
XXXXXBXXXXX
XTTTTXTTTTT
XTTTTXTTTTS
XTTTTXTTTTX
XTTTTXTTTTX
XTTTTXTTTTX
XXXSTXXXXXX