TTTXXSXXTTT
TTXXTTTXXTT
TXXTTTTTXXT
TTXXXXXXXTT
TTTTTXTTTTT
TTTTTXTTTTT
TTTTTXTTTTT
TTTTTXTTTTT
TXXXXXXXXXT
TXTTTTTTTXT
TXXXXXXXXXT
TTTTTXTTTTT
TTTTTBTTTTT