TTTTTTTTTTS
XXXXXXXXTTX
XTTTTTTXTTX
XTTTTTTXTTX
XTTXXXXXTTX
XTTXTTTTTTX
XTTXTBXXXTX
XTTXTTTTXTX
XTTXTTTTXTX
XTTXXXXXXTX
XTTTTTTTTTX
XTTTTTTTTTX
XXXXXXXXXXX