TXXXXXXXXXX
TXTTTTTTTTX
TXTTTTTTTTX
TXXXXXXTTTX
TTTTTTXXTTS
TTTTTTTXTTT
TTTTTTTXXXB
TTTTTTTXTTT
TTTTTTXXTTS
TXXXXXXTTTX
TXTTTTTTTTX
TXTTTTTTTTX
TXXXXXXXXXX