STTTTXXXXXS
XTTTTXTTTTT
XTTTTXTTTTT
XTTTTXTTTTT
XTTTTXTTTTT
XTTTTXTTTTT
XXXXXBXXXXX
TTTTTXTTTTX
TTTTTXTTTTX
TTTTTXTTTTX
TTTTTXTTTTX
TTTTTXTTTTX
SXXXXXTTTTS