TTTTTSTTTTT
TTXXXXXXXTT
TXXTTXTTXXT
XXTTTXTTTXX
XTTFFXFFTTX
XTTFXXXFTTX
XXXXXBXXXXX
XTTFXXXFTTX
XTTFFXFFTTX
XXTTTXTTTXX
TXXTTXTTXXT
TTXXXXXXXTT
TTTTTSTTTTT