XSXFXSXFXSX
XXXXXXXXXXX
XFFFFFFFFFX
XFTTTFTTTFX
XFTTTFTTTFX
XFFFFFFFFFX
XFFFTTTFFFX
XFFFTTTFFFX
XTTFTTTFTTX
XTTFFFFFTTX
XTTFFFFFTTX
XXTTTBTTTXX
XXXXXXXXXXX