XXXXXXXXXXX
XBTTTTTTXTT
XTTXXXXXXXX
XTTXTTTTTTX
XTTXTTTTTTX
XTTXXXXXXXX
XTTXTTXTTTX
XTTXTTXTTTX
XTTXTTSTTTX
XXXXTTTTTTX
XTTXXXXXXXX
XTTTTTTTTTS
SXXXXXXXXXX