XXXTTTXTTTT
XBXTTTXTTTT
XXXXXXXTTTT
TTXTTTXTTTT
TTXTTTXXXXX
TTXTTTTTXTT
TTXTTTTTXTT
TTXTSXXXXXX
TTXTTTTTTTX
TTXTTTTTTTX
TTXTTTTTTTX
XXXXXXXXSXX
TTTTTTTTTTT