TSTFTSTFTST
TXTFTXTFTXT
TXTXXXXXTXT
XXXXTTTXXXX
TTXXFFFXXTT
TTXXFFFXXTT
TTXXFFFXXTT
TXXXXXXXXXT
XXXXXXXXXXX
XXXTTTTTXXX
XXXXTTTXXXX
TTTXXXXXTTT
TTTXXBXXTTT