TTTXTXTXTXT
XSXXXXXXXSX
TTXTXTTTXXT
TTTTTTTXXTT
TTTTTTXXTTT
TTTTTXXTTTT
TTTTXXTTTTT
TTTXXTTTTTT
TTXXTTTTTTT
TXXTTTXXBTT
TXTTTXXTTTT
TXXTXXTTTTT
TTXXXTTTTTT