FFFFXSXFFFF
FFFFFXFFFFF
FTTTTXTTTTF
FTTTTXTTTTF
FFFXXXXXFFF
FFFXTTTXFFF
FFFXTTTXFFF
FFFXXXXXFFF
FFFFFXFFFFF
FTTTTXTTTTF
FTTTTXTTTTF
FFFFXXXFFFF
FFFFXBXFFFF