SXTTTTTTTXS
TXXXXXXXXXT
TTXXTTTXXTT
TTTXXTXXTTT
TTTTXTXTTTT
TTTXXTXXTTT
TTXXTTTXXTT
TXXTTTTTXXT
XXTXXXXXTXX
XTXXTXTXXTX
XXXTTXTTXXX
TTTTTXTTTTT
TTTTTBTTTTT