TSTTFSFTTST
TXXTFFFTXXT
TTXXTTTXXTT
TTXXTTTXXTT
TTXFFFFFXTT
XXXFFFFFXXX
XTFFTTTFFTX
XTFFTTTFFTX
XTTFFFFFTTX
XXXXXXXXXXX
XXTTTXTTTXX
XXTTXXXTTXX
XXTTXBXTTXX