FFFFFSFFFFF
FFFFFXFFFFF
TTTTTXTTTTT
TTTTTXTTTTT
TXXXTXTTFFF
TXTXTXTTFFF
SXXXXBXXXXS
FFFTTXTXTXT
FFFTTXTXXXT
TTTTTXTTTTT
TTTTTXTTTTT
FFFFFXFFFFF
FFFFFSFFFFF