SXXXXXXXXXS
XTTXTTTXTTX
XTTXTTTXTTX
XTTXFFFXTTX
XTTXFFFXTTX
XTTXFFFXTTX
XTTXFFFXTTX
XTTXFFFXTTX
XTTXFFFXTTX
XTTXTTTXTTX
XXXXTTTXXXX
TTTXTTTXTTT
XXXXXBXXXXX