SXXXXXXXXXS
XTTXTFTXTTX
XTTXTFTXTTX
XTTXFFFXTTX
XTTXFFFXTTX
XTTXFFFXTTX
XTTXFFFXTTX
XTTXFFFXTTX
XTTXFFFXTTX
XTTXTFTXTTX
XXXXTFTXXXX
TTTXTFTXTTT
TTTXXBXXTTT