XXXXXXXXXXX
XTTTTTTTTTX
XTTTTTTTTTX
XTXXXXXXXTX
XTXTTTTTXTX
XTXTXXXTXTX
XTXTSTXTXTX
XTXTTTXTXTX
XTXXXXXTXTX
XTTTTTTTXTX
XXXXXXXXXTX
TTTTTTTTTTX
TTTTTTTTTTB