SXXXXXXXXXS
TTTTTXTTTTT
TSTTXXXTTST
TXTTXTXTTXT
TXXXXTXXXXT
TTTTXTXTTTT
TTTXXXXXTTT
TTXXTXTXXTT
TXXTTXTTXXT
TXTTTXTTTXT
TXTTTXTTTXT
TXTTTXTTTXT
TXXXXBXXXXT