SXXXXSXXXXS
XXXXXXXXXXX
TTXTTXTTXTT
TTXTTXTTXTT
XXXXXXXXXXX
XXXXXXXXXXX
TTXTTXTTXTT
TTXTTXTTXTT
XXXXXXXXXXX
TTXTTXTTXTT
TTXTTXTTXTT
TTXXXXXXXTT
TTXXXBXXXTT