XXXXTTTXXXX
XTTXTTTXTTX
XTTXXXXXXXS
XTTTTTTTTTT
XXXXXTTTTTT
FFFFXTTTTTB
TTTTXTFFFFX
TTTTXTFXXXX
XXXXXTFXFFF
XFFFFTFXTTT
XTTTTTFXXTT
XXXXXTTTXTT
TTTTXXXXXTT