TTTTTTTTTTT
TXXXXXTTXSX
TXTTTXXTXTX
TXXXXTXXXTX
TTTTXXTTTXX
TTTXXTTTTXT
TTXXTTTTTXT
TXXXXXXXXXT
TXTTTTTXTTT
TXTTBTTXXTT
TXTTXTTTXXT
TXXXXTTTTXT
TTTTTTSXXXT