TSTFFSFFTST
TXXXXXXXXXT
TTXXTTTXXTT
TTXXTTTXXTT
TTXFFFFFXTT
XXXFFFFFXXX
XTFFTTTFFTX
XTTFTTTFTTX
XTTFFFFFTTX
XXXXXXXXXXX
XXTTTXTTTXX
XXTTXXXTTXX
XXTTXBXTTXX