XSXFXSXFXSX
XXXFXXXFXXX
FFFFFFFFFFF
FFTTTFTTTFF
FFTTTFTTTFF
FFFFFFFFFFF
FFFFTTTFFFF
FFFFTTTFFFF
TTTFXXXFTTT
TTTFFFFFTTT
TTTFFFFFTTT
XXTTTBTTTXX
XXXXXXXXXXX