TTTTTTTTTTT
TXXXXXXXXXT
TXTTTTTTTXT
TXTTXXXTTXT
TXXXXTXXTXS
TTTTTTTXTTT
TTTTTTTXXXB
TTTTTTTXTTT
TXXXXTXXTXS
TXTTXXXTTXT
TXTTTTTTTXT
TXXXXXXXXXT
TTTTTTTTTTT