TTTTTTTTTST
TTTTTTTTTXT
TXXXXXTTXXT
TXTTXXXXXTT
TXTTTTTTTTT
TXXXXXXTTTT
TXTTTTXTXXB
TXTTTXXTXTT
TXTTTXTTXTT
TXXXXXTTXXT
TXTTTTTTTXT
TXXXXXXXXXT
TTTTTTTTTTT