STTSTTTSTTS
XTTXTTTXTTX
XTTXTTTXTTX
XTTXTTTXTTX
XTTXTTTXTTX
XTTXTTTXTTX
XXXXXBXXXXX
XTTXTTTXTTX
XTTXTTTXTTX
XTTXTTTXTTX
XTTXTTTXTTX
XTTXTTTXTTX
STTSTTTSTTS